##############
#S    #      #
#  # ### ### #
#  #       # #
### #### # # #
#      # #   #
# #### ### ###
# #  #     # #
# # ######  E#
##############